StudentID,Grade,Attempt,Date,Reading,Math,Writing,Total
12010032,12,1,10/1/2010,350,410,380,1140
12010032,12,2,3/1/2011,340,340,420,1100
12010032,12,3,6/1/2011,330,340,310,980
12020025,12,1,10/1/2010,370,410,380,1160
12020025,12,2,3/1/2011,410,380,340,1130
12020025,12,3,6/1/2011,380,420,420,1220
12030003,12,1,10/1/2010,340,500,510,1350
12030003,12,2,3/1/2011,460,490,460,1410
12030003,12,3,6/1/2011,470,420,450,1340
12030008,12,1,10/1/2010,290,450,330,1070
12030008,12,2,3/1/2011,390,500,370,1260
12030008,12,3,6/1/2011,360,420,330,1110
12030013,12,1,10/1/2010,590,590,520,1700
12030013,12,2,3/1/2011,500,610,530,1640
12030013,12,3,6/1/2011,510,590,550,1650
12030017,12,1,10/1/2010,380,400,430,1210
12030017,12,2,3/1/2011,440,440,480,1360
12030017,12,3,6/1/2011,530,450,570,1550
12030019,12,1,10/1/2010,360,250,440,1050
12030019,12,2,3/1/2011,400,340,410,1150
12030019,12,3,6/1/2011,400,350,370,1120
12030025,12,1,10/1/2010,440,470,410,1320
12030025,12,2,3/1/2011,400,460,460,1320
12030025,12,3,6/1/2011,460,420,420,1300
12030027,12,1,10/1/2010,420,480,440,1340
12030031,12,1,10/1/2011,530,520,510,1560
12030031,12,2,10/1/2012,570,550,490,1610
12030033,12,1,10/1/2010,440,360,420,1220
12030033,12,2,3/1/2011,400,380,370,1150
12030033,12,3,6/1/2011,340,410,390,1140
12030036,12,1,10/1/2010,510,510,510,1530
12030036,12,2,3/1/2011,530,540,420,1490
12030036,12,3,6/1/2011,490,490,430,1410
12030049,12,1,10/1/2010,380,470,380,1230
12030049,12,2,3/1/2011,480,510,430,1420
12030049,12,3,6/1/2011,440,490,420,1350
12030052,12,1,10/1/2010,370,350,380,1100
12030052,12,2,3/1/2011,330,370,360,1060
12030052,12,3,6/1/2011,420,380,390,1190
12030053,12,1,10/1/2010,320,350,320,990
12030053,12,2,3/1/2011,360,340,390,1090
12030053,12,3,6/1/2011,350,370,370,1090
12030056,12,1,10/1/2010,540,470,630,1640
12030056,12,2,3/1/2011,700,530,620,1850
12030056,12,3,6/1/2011,570,500,700,1770
12030061,12,1,3/1/2011,520,470,350,1340
12030061,12,2,6/1/2011,450,490,350,1290
12040002,11,1,3/1/2011,360,410,410,1180
12040002,11,2,6/1/2011,390,430,410,1230
12040002,12,3,10/1/2011,390,430,430,1250
12040003,11,1,3/1/2011,360,340,400,1100
12040003,11,2,6/1/2011,400,400,430,1230
12040003,12,3,10/1/2011,430,440,430,1300
12040027,11,1,3/1/2011,510,630,560,1700
12040027,11,2,6/1/2011,520,620,690,1830
12040027,12,3,10/1/2011,600,630,710,1940
12040036,11,1,3/1/2012,590,650,620,1860
12040036,11,2,5/1/2012,680,690,640,2010
12040038,11,1,3/1/2011,440,430,450,1320
12040038,11,2,6/1/2011,380,460,560,1400
12040038,12,3,10/1/2011,430,500,560,1490
12040040,11,1,3/1/2012,560,440,490,1490
12040040,11,2,5/1/2012,500,400,540,1440
12040040,12,3,10/1/2012,510,440,410,1360
12040041,11,1,3/1/2011,440,500,520,1460
12040041,12,2,10/1/2011,450,530,520,1500
12040044,10,1,3/1/2011,440,490,550,1480
12040044,10,2,6/1/2011,450,540,560,1550
12040044,12,3,10/1/2011,450,510,560,1520
12040048,11,1,3/1/2011,520,480,510,1510
12040048,11,2,6/1/2011,530,520,500,1550
12040048,12,3,10/1/2011,530,520,570,1620
12040053,11,1,3/1/2011,560,580,510,1650
12040053,11,2,6/1/2011,570,610,580,1760
12040053,12,3,10/1/2011,600,610,690,1900
12040062,12,1,10/1/2010,460,470,500,1430
12040062,12,2,3/1/2011,410,460,390,1260
12040062,12,3,6/1/2011,500,420,460,1380
12040067,11,1,3/1/2011,350,440,370,1160
12040067,11,2,6/1/2011,470,550,410,1430
12040073,11,1,3/1/2011,410,390,470,1270
12040073,11,2,6/1/2011,370,400,470,1240
12040075,12,1,10/1/2010,410,450,480,1340
12040075,12,2,3/1/2011,420,480,430,1330
12040075,12,3,6/1/2011,450,450,520,1420
12040078,11,1,3/1/2011,390,390,360,1140
12040078,11,2,6/1/2011,420,420,490,1330
12040078,12,3,10/1/2011,420,420,490,1330
12050016,11,1,3/1/2013,500,500,510,1510
12050016,11,2,5/4/2013,570,460,500,1530
12050016,11,3,6/1/2013,570,500,490,1560
12050024,11,1,3/1/2013,640,660,660,1960
12050024,11,2,5/4/2013,630,650,660,1940
12050024,11,3,6/1/2013,630,650,660,1940
12050024,12,4,10/5/2013,620,710,620,1950
12050026,11,1,3/1/2012,350,490,440,1280
12050026,11,2,5/1/2012,390,480,470,1340
12050026,11,3,6/1/2012,380,440,420,1240
12050031,11,1,3/1/2013,360,350,330,1040
12050031,11,2,5/4/2013,410,380,390,1180
12050031,11,3,6/1/2013,370,380,380,1130
12050031,12,4,10/5/2013,410,390,370,1170
12050033,11,1,3/1/2012,630,580,740,1950
12050033,11,2,5/1/2012,650,570,670,1890
12050033,11,3,6/1/2012,450,480,510,1440
12050033,12,4,10/1/2012,640,610,690,1940
12050034,11,1,3/1/2012,390,480,470,1340
12050034,11,2,5/1/2012,470,480,550,1500
12050034,12,3,10/1/2012,400,480,460,1340
12050040,11,1,3/1/2012,470,510,540,1520
12050040,11,2,5/1/2012,490,530,520,1540
12050040,11,3,6/1/2012,510,490,560,1560
12050040,12,4,10/1/2012,470,510,570,1550
12050049,11,1,3/1/2012,440,550,520,1510
12050049,11,2,5/1/2012,490,580,500,1570
12050049,12,3,10/1/2012,440,580,520,1540
12050055,11,1,3/1/2012,530,650,670,1850
12050055,12,2,10/1/2012,380,480,470,1330
12050057,11,1,3/1/2012,570,500,580,1650
12050057,11,2,5/1/2012,550,520,620,1690
12050057,12,3,10/1/2012,540,510,500,1550
12050060,11,1,3/1/2012,570,650,600,1820
12050060,11,2,5/1/2012,570,630,620,1820
12050060,12,3,10/1/2012,590,650,560,1800
12050061,11,1,3/1/2012,390,340,360,1090
12050061,11,2,5/1/2012,420,400,430,1250
12050061,11,3,6/1/2012,420,370,350,1140
12050061,12,4,10/1/2012,430,390,400,1220
12050062,11,1,3/1/2012,450,590,520,1560
12050062,11,2,5/1/2012,410,590,510,1510
12050062,12,3,10/1/2012,400,580,480,1460
12050063,11,1,3/1/2013,370,490,420,1280
12050063,11,2,5/4/2013,440,490,430,1360
12050063,11,3,6/1/2013,420,570,480,1470
12050063,12,4,10/5/2013,390,540,400,1330
12050069,11,1,3/1/2011,380,490,410,1280
12050069,11,2,6/1/2011,450,500,460,1410
12050069,12,3,10/1/2011,450,500,470,1420
12050073,11,1,3/1/2011,320,350,320,990
12050073,11,2,6/1/2011,240,350,300,890
12050073,11,3,3/1/2012,260,300,330,890
12050073,11,4,5/1/2012,270,310,270,850
12050073,11,5,6/1/2012,310,370,260,940
12050073,12,6,10/1/2012,320,410,310,1040
12050078,11,1,3/1/2011,360,510,460,1330
12050078,11,2,6/1/2011,430,510,560,1500
12050078,11,3,3/1/2012,490,550,520,1560
12050078,11,4,5/1/2012,480,570,560,1610
12050078,12,5,10/1/2012,470,510,460,1440
12050088,12,1,10/1/2010,390,350,420,1160
12050088,12,2,3/1/2011,380,440,420,1240
12050088,12,3,6/1/2011,390,380,440,1210
12050091,11,1,3/1/2011,560,520,540,1620
12050091,11,2,6/1/2011,560,540,520,1620
12050091,12,3,10/1/2011,560,540,560,1660
12060006,11,1,3/8/2014,350,350,360,1060
12060006,11,2,6/7/2014,330,280,310,920
12060006,12,3,10/11/2014,320,270,410,1000
12060010,11,1,3/1/2013,370,450,460,1280
12060010,11,2,5/4/2013,400,470,430,1300
12060010,11,3,6/1/2013,330,440,450,1220
12060010,12,4,10/5/2013,360,520,470,1350
12060018,11,1,5/4/2013,510,520,580,1610
12060018,11,2,6/1/2013,480,560,560,1600
12060018,12,3,10/5/2013,550,530,520,1600
12060024,11,1,3/1/2013,660,640,610,1910
12060024,11,2,5/4/2013,710,610,640,1960
12060024,11,3,6/1/2013,710,610,640,1960
12060024,12,4,10/5/2013,710,710,670,2090
12060033,11,1,3/1/2013,490,530,400,1420
12060033,11,2,5/4/2013,490,530,430,1450
12060033,11,3,6/1/2013,490,530,430,1450
12060033,12,4,10/5/2013,560,520,460,1540
12060041,11,1,3/1/2013,430,400,440,1270
12060041,11,2,5/4/2013,430,400,530,1360
12060041,11,3,6/1/2013,420,460,450,1330
12060041,12,4,10/5/2013,380,430,450,1260
12060045,11,1,5/4/2013,370,390,470,1230
12060045,11,2,6/1/2013,370,370,480,1220
12060045,12,3,10/5/2013,390,400,440,1230
12060046,11,1,3/1/2013,480,520,600,1600
12060046,11,2,5/4/2013,500,530,570,1600
12060046,11,3,6/1/2013,430,540,550,1520
12060046,12,4,10/5/2013,400,530,570,1500
12060048,11,1,3/1/2013,380,390,440,1210
12060048,11,2,5/4/2013,410,380,420,1210
12060048,11,3,6/1/2013,370,410,540,1320
12060052,11,1,3/1/2013,270,400,430,1100
12060052,11,2,5/4/2013,310,420,510,1240
12060052,11,3,6/1/2013,340,480,510,1330
12060052,12,4,10/5/2013,360,470,410,1240
12060055,11,1,3/1/2013,620,600,610,1830
12060055,11,2,5/4/2013,600,650,640,1890
12060055,11,3,6/1/2013,600,650,640,1890
12060058,11,1,3/1/2013,440,450,540,1430
12060058,11,2,5/4/2013,480,500,560,1540
12060058,11,3,6/1/2013,480,490,530,1500
12060060,11,1,3/1/2013,490,510,540,1540
12060060,11,2,5/4/2013,500,530,560,1590
12060060,11,3,6/1/2013,550,520,590,1660
12060060,12,4,10/5/2013,520,510,560,1590
12060065,11,1,3/1/2013,460,430,530,1420
12060065,11,2,5/4/2013,420,450,480,1350
12060065,11,3,6/1/2013,490,450,510,1450
12060065,12,4,10/5/2013,440,480,490,1410
12060070,11,1,3/1/2013,420,430,460,1310
12060070,11,2,5/4/2013,470,450,530,1450
12060070,11,3,6/1/2013,490,450,590,1530
12060070,12,4,10/5/2013,520,500,560,1580
12060073,11,1,3/1/2011,320,390,280,990
12060073,11,2,6/1/2011,310,390,350,1050
12060073,12,3,10/1/2011,390,390,350,1130
12060074,11,1,3/1/2011,310,370,400,1080
12060074,11,2,6/1/2011,270,370,420,1060
12060074,11,3,3/1/2012,350,400,320,1070
12060074,11,4,5/1/2012,380,350,420,1150
12060074,11,5,6/1/2012,370,390,400,1160
12060074,12,6,10/1/2012,310,390,350,1050
12060077,11,1,3/1/2011,390,340,410,1140
12060077,11,2,6/1/2011,400,430,430,1260
12060077,12,3,10/1/2011,430,440,430,1300
12060080,11,1,3/1/2012,510,610,540,1660
12060080,11,2,5/1/2012,480,600,610,1690
12060080,12,3,10/1/2012,530,590,570,1690
12060085,11,1,3/1/2012,650,560,620,1830
12060085,11,2,5/1/2012,650,580,660,1890
12060085,12,3,10/1/2012,630,580,670,1880
21040007,11,1,3/14/2015,410,350,440,1200
21040023,11,1,3/14/2015,520,520,570,1610
21040024,11,1,3/14/2015,510,540,530,1580
21040037,11,1,3/14/2015,440,510,590,1540
21040046,11,1,3/14/2015,380,470,480,1330
22040006,11,1,3/1/2011,280,490,340,1110
22040006,12,2,10/1/2011,370,490,440,1300
22040008,11,1,3/1/2012,400,480,500,1380
22040008,11,2,5/1/2012,430,460,470,1360
22040008,11,3,6/1/2012,470,470,460,1400
22040009,11,1,3/1/2011,610,560,640,1810
22040009,11,2,6/1/2011,630,650,620,1900
22040009,12,3,10/1/2011,690,670,680,2040
22040015,11,1,3/1/2013,430,480,430,1340
22040015,11,2,6/1/2013,370,470,390,1230
22040015,12,3,10/5/2013,390,500,440,1330
22040018,11,1,3/1/2011,470,600,480,1550
22040018,11,2,6/1/2011,510,670,490,1670
22040018,12,3,10/1/2011,510,660,490,1660
22040019,11,1,3/1/2011,330,380,360,1070
22040019,11,2,6/1/2011,390,400,400,1190
22040019,12,3,10/1/2011,390,500,430,1320
22040024,11,1,3/1/2011,430,480,510,1420
22040024,11,2,6/1/2011,380,450,460,1290
22040024,12,3,10/1/2011,400,500,460,1360
22040032,11,1,3/1/2011,500,560,500,1560
22040032,11,2,6/1/2011,530,600,500,1630
22040032,12,3,10/1/2011,530,590,520,1640
22040041,11,1,3/1/2011,330,400,330,1060
22040041,11,2,6/1/2011,390,410,410,1210
22040041,12,3,10/1/2011,390,420,410,1220
22040042,11,1,3/1/2011,540,560,580,1680
22040042,11,2,6/1/2011,570,640,630,1840
22040042,12,3,10/1/2011,570,640,700,1910
22040047,11,1,3/1/2011,350,500,360,1210
22040047,12,2,10/1/2011,550,530,500,1580
22040048,11,1,3/1/2011,440,450,450,1340
22040048,11,2,6/1/2011,470,460,530,1460
22040048,12,3,10/1/2011,560,500,530,1590
22040051,11,1,3/1/2011,410,470,440,1320
22040051,11,2,6/1/2011,380,500,480,1360
22040051,12,3,10/1/2011,440,510,480,1430
22050001,11,1,3/1/2011,430,520,490,1440
22050001,11,2,6/1/2011,450,490,460,1400
22050001,12,3,10/1/2011,450,520,510,1480
22050003,11,1,3/1/2012,390,550,470,1410
22050003,11,2,5/1/2012,480,570,540,1590
22050003,12,3,10/1/2012,380,520,430,1330
22050004,11,1,3/1/2013,420,400,390,1210
22050004,11,2,5/4/2013,440,440,440,1320
22050004,11,3,6/1/2013,420,420,520,1360
22050004,12,4,10/5/2013,480,470,460,1410
22050013,11,1,3/1/2012,360,470,450,1280
22050013,11,2,6/1/2012,280,430,390,1100
22050017,11,1,3/1/2012,540,600,530,1670
22050017,11,2,5/1/2012,540,600,560,1700
22050017,12,3,10/1/2012,520,620,480,1620
22050018,11,1,3/1/2013,560,480,440,1480
22050018,11,2,5/4/2013,520,450,560,1530
22050018,11,3,6/1/2013,560,480,480,1520
22050018,12,4,10/5/2013,540,400,460,1400
22050035,11,1,5/1/2012,450,470,540,1460
22050035,12,2,10/1/2012,430,460,530,1420
22050044,11,1,3/1/2012,410,510,530,1450
22050044,11,2,5/1/2012,450,520,480,1450
22050044,12,3,10/1/2012,390,480,350,1220
22050047,11,1,3/1/2013,320,400,330,1050
22050047,11,2,5/4/2013,380,440,380,1200
22050047,11,3,6/1/2013,340,420,370,1130
22050047,12,4,10/5/2013,320,430,310,1060
22050050,11,1,3/1/2011,440,450,510,1400
22050050,11,2,6/1/2011,480,520,490,1490
22050050,12,3,10/1/2011,480,520,510,1510
22050057,11,1,3/1/2011,530,600,550,1680
22050057,11,2,6/1/2011,530,590,590,1710
22050057,12,3,10/1/2011,550,600,590,1740
22060008,11,1,3/1/2013,380,380,480,1240
22060008,11,2,5/4/2013,410,440,440,1290
22060008,11,3,6/1/2013,470,400,450,1320
22060012,11,1,3/1/2013,470,480,530,1480
22060012,11,2,5/4/2013,450,470,490,1410
22060012,11,3,6/1/2013,460,520,520,1500
22060012,12,4,10/5/2013,450,500,520,1470
22060016,11,1,5/4/2013,530,470,520,1520
22060016,11,2,6/1/2013,510,590,500,1600
22060016,12,3,10/5/2013,470,480,430,1380
22060017,11,1,3/1/2013,470,400,540,1410
22060017,11,2,5/4/2013,500,430,530,1460
22060017,11,3,6/1/2013,480,510,530,1520
22060017,12,4,10/5/2013,490,470,540,1500
22060018,11,1,3/1/2013,320,210,290,820
22060018,11,2,5/4/2013,230,310,300,840
22060018,11,3,6/1/2013,270,240,320,830
22060020,11,1,3/1/2011,410,510,420,1340
22060020,11,2,6/1/2011,430,510,490,1430
22060020,12,3,10/1/2011,430,520,490,1440
22060025,11,1,3/8/2014,420,410,410,1240
22060025,11,2,6/7/2014,440,470,420,1330
22060025,12,3,10/11/2014,400,470,360,1230
22060029,11,1,3/8/2014,330,550,460,1340
22060029,11,2,6/7/2014,350,550,450,1350
22060029,12,3,10/11/2014,340,490,360,1190
22060033,11,1,3/1/2013,460,490,530,1480
22060033,11,2,5/4/2013,500,470,580,1550
22060033,11,3,6/1/2013,510,490,590,1590
22060033,12,4,10/5/2013,480,520,530,1530
22060038,11,1,3/8/2014,390,510,360,1260
22060038,11,2,6/7/2014,400,530,410,1340
22060038,12,3,10/11/2014,410,550,350,1310
22060040,11,1,3/1/2013,480,490,590,1560
22060040,11,2,5/4/2013,480,500,590,1570
22060040,11,3,6/1/2013,470,470,550,1490
22060040,12,4,10/5/2013,500,530,580,1610
22060042,11,1,3/1/2013,360,410,440,1210
22060042,11,2,5/4/2013,430,450,350,1230
22060042,11,3,6/1/2013,390,430,440,1260
22060042,12,4,10/5/2013,330,330,430,1090
22060043,11,1,3/8/2014,390,430,420,1240
22060043,11,2,6/7/2014,420,450,410,1280
22060043,12,3,10/11/2014,440,470,390,1300
22060049,11,1,3/1/2013,460,490,510,1460
22060049,11,2,6/1/2013,480,510,550,1540
22060049,12,3,10/5/2013,480,500,470,1450
22060050,11,1,3/1/2013,490,590,530,1610
22060050,11,2,5/4/2013,470,550,470,1490
22060050,11,3,6/1/2013,520,550,580,1650
22060050,12,4,10/5/2013,550,550,520,1620
22060053,11,1,3/1/2013,430,580,490,1500
22060053,11,2,5/4/2013,430,540,550,1520
22060053,11,3,6/1/2013,390,590,540,1520
22060053,12,4,10/5/2013,500,580,570,1650
22060058,11,1,3/1/2013,360,310,400,1070
22060058,11,2,5/4/2013,360,330,400,1090
22060058,11,3,6/1/2013,360,370,480,1210
22060059,11,1,3/8/2014,500,410,520,1430
22060059,11,2,6/7/2014,490,430,500,1420
22060059,12,3,10/11/2014,500,400,440,1340
22060061,11,1,6/7/2014,320,350,400,1070
32050002,10,1,6/1/2011,440,350,430,1220
32050002,11,2,3/1/2012,370,430,410,1210
32050002,11,3,6/1/2012,430,450,410,1290
32050002,12,4,10/1/2012,400,430,390,1220
32050007,10,1,6/1/2011,480,470,310,1260
32050007,11,2,3/1/2012,540,610,520,1670
32050007,11,3,6/1/2012,600,590,580,1770
32050015,11,1,3/1/2012,440,390,380,1210
32050015,11,2,6/1/2012,560,370,440,1370
32050016,10,1,6/1/2011,550,410,400,1360
32050016,11,2,3/1/2012,590,550,560,1700
32050016,11,3,6/1/2012,630,580,570,1780
32050020,10,1,6/1/2011,570,450,490,1510
32050020,11,2,3/1/2012,590,540,650,1780
32050020,11,3,6/1/2012,660,520,620,1800
32050020,12,4,10/1/2012,620,570,610,1800
32050028,10,1,6/1/2011,400,470,320,1190
32050028,11,2,3/1/2012,410,550,550,1510
32050028,11,3,6/1/2012,460,650,510,1620
32050028,12,4,10/1/2012,530,560,460,1550
32050030,11,1,3/1/2012,460,430,570,1460
32050030,11,2,6/1/2012,530,450,600,1580
32050030,12,3,10/1/2012,630,540,540,1710
32050037,10,1,6/1/2011,570,540,450,1560
32050041,10,1,6/1/2011,350,210,200,760
32050041,11,2,3/1/2012,360,380,380,1120
32050041,11,3,6/1/2012,340,400,380,1120
32050041,12,4,10/1/2012,390,440,280,1110
32050046,11,1,1/15/2013,320,500,440,1260
32050046,12,2,10/5/2013,330,490,300,1120
32050047,10,1,6/1/2011,370,370,320,1060
32050047,11,2,3/1/2012,380,600,500,1480
32050047,11,3,6/1/2012,400,600,420,1420
32050048,10,1,6/1/2011,340,320,220,880
32050048,11,2,1/15/2013,370,420,330,1120
32050048,11,3,5/4/2013,270,350,240,860
32050048,12,4,10/5/2013,340,430,280,1050
32050051,10,1,6/1/2011,380,310,310,1000
32050051,11,2,3/1/2012,410,470,470,1350
32050051,11,3,6/1/2012,430,460,500,1390
32050051,12,4,10/1/2012,490,520,520,1530
32050061,10,1,6/1/2011,360,450,330,1140
32050061,11,2,3/1/2012,340,530,470,1340
32050061,11,3,6/1/2012,330,600,420,1350
32050061,12,4,10/1/2012,360,580,470,1410
32050063,11,1,3/1/2012,500,510,580,1590
32050063,11,2,6/1/2012,470,530,590,1590
32050064,11,1,3/1/2012,370,470,440,1280
32050064,11,2,6/1/2012,340,490,430,1260
32050064,12,3,10/1/2012,310,490,420,1220
32050065,10,1,6/1/2011,430,440,300,1170
32050065,11,2,3/1/2012,500,510,550,1560
32050065,11,3,6/1/2012,500,510,560,1570
32050065,12,4,10/1/2012,520,530,500,1550
32050068,10,1,6/1/2011,310,NA,NA,310
32050068,11,2,3/1/2012,400,470,430,1300
32050068,11,3,6/1/2012,390,430,450,1270
32050068,12,4,10/1/2012,440,490,440,1370
32050069,10,1,6/1/2011,370,310,250,930
32050069,11,2,3/1/2012,340,480,420,1240
32050069,11,3,6/1/2012,430,510,470,1410
32050069,12,4,10/1/2012,390,470,460,1320
32050073,10,1,6/1/2011,450,340,410,1200
32050073,11,2,3/1/2012,440,460,520,1420
32050073,11,3,6/1/2012,450,490,500,1440
32050073,12,4,10/1/2012,460,510,460,1430
32050082,11,1,3/1/2012,520,500,580,1600
32050082,11,2,6/1/2012,470,550,560,1580
32060001,11,1,1/15/2013,370,480,360,1210
32060001,11,2,5/4/2013,370,470,410,1250
32060006,11,1,1/15/2013,510,480,480,1470
32060006,11,2,5/4/2013,520,490,560,1570
32060006,12,3,10/5/2013,540,500,510,1550
32060009,11,1,1/15/2013,450,540,470,1460
32060009,11,2,5/4/2013,450,580,420,1450
32060009,12,3,10/5/2013,410,560,530,1500
32060022,11,1,1/15/2013,480,520,490,1490
32060022,11,2,5/4/2013,460,510,570,1540
32060022,12,3,10/5/2013,500,460,580,1540
32060023,11,1,1/15/2013,440,490,440,1370
32060023,11,2,5/4/2013,420,520,520,1460
32060023,12,3,10/5/2013,460,480,510,1450
32060026,11,1,1/15/2013,350,300,350,1000
32060026,12,2,10/5/2013,260,400,380,1040
32060028,11,1,1/24/2015,280,390,300,970
32060034,11,1,1/15/2013,400,400,400,1200
32060034,11,2,5/4/2013,350,480,340,1170
32060034,12,3,10/5/2013,390,440,350,1180
32060035,11,1,1/15/2013,460,480,430,1370
32060035,11,2,5/4/2013,430,470,490,1390
32060035,12,3,10/5/2013,350,510,470,1330
32060039,11,1,1/15/2013,420,480,380,1280
32060039,11,2,6/1/2013,430,600,460,1490
32060041,11,1,1/15/2013,480,550,490,1520
32060041,11,2,5/4/2013,450,500,470,1420
32060041,12,3,10/5/2013,480,500,480,1460
32060044,11,1,1/15/2013,510,580,470,1560
32060044,11,2,5/4/2013,470,550,440,1460
32060044,12,3,10/5/2013,410,570,360,1340
32060051,11,1,1/15/2013,420,440,390,1250
32060051,11,2,5/4/2013,310,470,400,1180
32060051,12,3,10/5/2013,360,460,360,1180
32060059,11,1,1/15/2013,400,370,410,1180
32060059,11,2,5/4/2013,340,400,400,1140
32060067,11,1,1/15/2013,460,500,450,1410
32060067,11,2,5/4/2013,420,510,520,1450
32060067,12,3,10/5/2013,440,480,490,1410
32060072,11,1,1/15/2013,540,590,580,1710
32060072,11,2,5/4/2013,530,710,590,1830
32060072,12,3,10/5/2013,500,600,490,1590
32060075,11,1,1/15/2013,490,400,460,1350
32060075,11,2,5/4/2013,430,410,460,1300
32060075,12,3,10/5/2013,410,440,470,1320
32060078,11,1,6/7/2014,380,340,270,990
32060081,11,1,1/15/2013,570,680,550,1800
32060081,11,2,5/4/2013,620,670,650,1940
32060081,12,3,10/5/2013,630,750,640,2020
32060089,10,1,6/1/2011,450,470,330,1250
32060089,11,2,3/1/2012,480,510,460,1450
32060089,11,3,6/1/2012,470,520,460,1450
32060089,12,4,10/1/2012,530,540,440,1510
32060095,10,1,6/1/2011,430,370,300,1100
32060095,11,2,3/1/2012,370,470,400,1240
32060095,11,3,6/1/2012,470,450,460,1380
32060095,12,4,10/1/2012,460,480,490,1430
32060096,10,1,6/1/2011,360,360,300,1020
32060096,11,2,3/1/2012,350,430,430,1210
32060096,11,3,6/1/2012,400,490,390,1280
32060096,12,4,10/1/2012,420,510,450,1380
32060098,10,1,6/1/2011,410,310,300,1020
32060098,11,2,3/1/2012,510,460,470,1440
32060098,11,3,6/1/2012,500,450,460,1410
32060098,12,4,10/1/2012,430,510,410,1350
32060099,10,1,6/1/2011,470,480,340,1290
32060099,11,2,3/1/2012,410,550,420,1380
32060099,11,3,6/1/2012,430,560,500,1490
32060099,12,4,10/1/2012,460,590,440,1490
62060003,11,1,1/15/2013,300,480,350,1130
62060003,11,2,6/1/2013,370,590,290,1250
62060003,12,3,10/5/2013,360,540,430,1330
62060006,11,1,5/3/2014,380,320,330,1030
62060011,11,1,1/15/2013,240,430,320,990
62060011,11,2,5/4/2013,320,420,390,1130
62060017,11,1,1/15/2013,430,530,450,1410
62060017,11,2,5/4/2013,380,560,390,1330
62060017,12,3,10/11/2014,440,590,420,1450
62060018,11,1,1/15/2013,420,460,430,1310
62060018,11,2,5/4/2013,440,420,410,1270
62060018,12,3,10/5/2013,600,470,510,1580
62060019,11,1,1/15/2013,380,430,380,1190
62060019,11,2,5/4/2013,370,420,370,1160
62060019,11,3,5/3/2014,250,450,350,1050
62060020,11,1,1/15/2013,380,330,360,1070
62060020,11,2,5/4/2013,270,340,350,960
62060027,11,1,1/15/2013,480,450,550,1480
62060027,11,2,5/4/2013,410,560,470,1440
62060027,12,3,10/5/2013,460,460,430,1350
62060029,11,1,1/15/2013,590,510,500,1600
62060029,11,2,5/4/2013,520,530,500,1550
62060029,12,3,10/5/2013,520,550,570,1640
62060035,11,1,1/15/2013,480,600,490,1570
62060035,11,2,5/4/2013,530,570,570,1670
62060035,12,3,10/5/2013,570,620,630,1820
62060042,11,1,5/3/2014,360,390,400,1150
62060043,11,1,1/15/2013,580,460,480,1520
62060043,11,2,5/4/2013,560,520,480,1560
62060043,12,3,10/5/2013,530,500,510,1540
62060051,11,1,1/15/2013,360,420,450,1230
62060051,11,2,5/4/2013,290,420,470,1180
62060060,11,1,1/15/2013,340,450,400,1190
62060060,11,2,5/4/2013,330,510,520,1360
62060061,11,1,1/15/2013,440,490,480,1410
62060061,11,2,5/4/2013,400,480,510,1390
62060061,12,3,10/5/2013,410,500,500,1410
62060063,11,1,1/15/2013,290,390,390,1070
62060063,11,2,5/4/2013,270,410,360,1040
62060063,12,3,10/5/2013,260,410,330,1000
62060068,11,1,1/15/2013,450,450,420,1320
62060068,11,2,5/4/2013,450,480,450,1380
62060068,12,3,10/5/2013,450,440,530,1420
62060074,11,1,1/15/2013,530,500,550,1580
62060074,11,2,5/4/2013,520,520,540,1580
62060074,12,3,10/5/2013,520,500,630,1650
62060076,11,1,1/15/2013,360,400,360,1120
62060076,11,2,5/4/2013,350,410,330,1090
62060080,11,1,5/3/2014,400,460,380,1240
62060081,11,1,1/15/2013,470,470,520,1460
62060081,11,2,5/4/2013,430,470,570,1470
62060081,12,3,10/5/2013,470,530,550,1550
62060084,11,1,1/15/2013,380,440,410,1230
62060084,11,2,5/4/2013,390,410,410,1210
70720001,11,1,3/14/2015,560,440,380,1380
80120007,11,1,3/8/2014,360,470,440,1270
80120007,11,2,6/7/2014,380,550,470,1400
80120007,12,3,10/11/2014,420,470,460,1350
80120009,11,1,3/8/2014,390,440,420,1250
80120011,11,1,3/8/2014,370,300,390,1060
80120011,11,2,5/3/2014,260,370,380,1010
80120021,11,1,3/14/2015,340,490,380,1210
80120024,11,1,3/8/2014,430,480,590,1500
80120024,11,2,6/7/2014,450,540,580,1570
80120024,12,3,10/11/2014,520,550,580,1650
80120026,11,1,3/8/2014,520,550,640,1710
80120026,11,2,6/7/2014,550,570,600,1720
80120026,12,3,10/11/2014,530,580,560,1670
80120027,11,1,3/8/2014,440,440,510,1390
80120027,11,2,6/7/2014,520,470,530,1520
80120027,12,3,10/11/2014,520,470,550,1540
80120031,11,1,3/8/2014,410,350,440,1200
80120031,11,2,6/7/2014,430,400,460,1290
80120031,12,3,10/11/2014,390,390,430,1210
80120033,11,1,3/8/2014,400,470,470,1340
80120033,11,2,6/7/2014,490,560,520,1570
80120033,12,3,10/11/2014,470,490,550,1510
80120039,11,1,3/8/2014,470,470,570,1510
80120039,11,2,6/7/2014,420,460,610,1490
80120039,12,3,10/11/2014,510,430,590,1530
80120042,11,1,6/7/2014,330,390,230,950
80120042,12,2,10/11/2014,440,450,330,1220
80120043,11,1,3/14/2015,490,460,470,1420
80120046,11,1,3/14/2015,520,560,530,1610
80120047,11,1,3/8/2014,340,390,370,1100
80120047,11,2,6/7/2014,360,440,300,1100
80120047,12,3,10/11/2014,360,390,380,1130
80120049,11,1,3/8/2014,500,490,540,1530
80120049,11,2,6/7/2014,540,520,570,1630
80120049,12,3,10/11/2014,580,490,550,1620
80120052,11,1,3/8/2014,540,550,630,1720
80120052,11,2,6/7/2014,590,620,630,1840
80120052,12,3,10/11/2014,580,600,710,1890
80120053,11,1,3/8/2014,570,660,630,1860
80120053,11,2,6/7/2014,620,690,630,1940
80120053,12,3,10/11/2014,610,730,610,1950
80120054,11,1,3/14/2015,300,360,360,1020
80120057,11,1,3/8/2014,520,510,520,1550
80120057,11,2,6/7/2014,420,540,500,1460
80120057,12,3,10/11/2014,540,560,560,1660
80120060,11,1,6/7/2014,400,410,430,1240
80120061,11,1,3/14/2015,320,420,370,1110
80120062,11,1,3/8/2014,340,400,450,1190
80120062,11,2,6/7/2014,420,330,420,1170
80120062,12,3,10/11/2014,370,340,420,1130
80120063,11,1,3/8/2014,420,450,460,1330
80120063,11,2,6/7/2014,390,470,510,1370
80120063,12,3,10/11/2014,430,450,530,1410
80120065,11,1,3/8/2014,370,420,470,1260
80120065,11,2,6/7/2014,460,410,450,1320
80120065,12,3,10/11/2014,430,400,480,1310
80120066,11,1,3/8/2014,300,370,390,1060
80120066,11,2,6/7/2014,340,370,390,1100
80120066,12,3,10/11/2014,330,350,370,1050
80120070,11,1,3/8/2014,510,400,440,1350
80120070,11,2,6/7/2014,500,510,540,1550
80120070,12,3,10/11/2014,500,480,490,1470
80120074,11,1,3/8/2014,500,510,500,1510
80120074,11,2,6/7/2014,520,520,570,1610
80120074,12,3,10/11/2014,480,530,600,1610
80120078,11,1,5/4/2013,540,490,610,1640
80120078,11,2,6/1/2013,500,520,590,1610
80120078,12,3,10/5/2013,520,530,510,1560
80120080,11,1,3/1/2011,440,440,470,1350
80120080,12,2,10/1/2011,390,480,430,1300
80120081,11,1,3/1/2011,390,520,410,1320
80120081,11,2,6/1/2011,390,540,420,1350
80120081,12,3,10/1/2011,390,580,420,1390
80120082,11,1,3/8/2014,410,500,510,1420
80120082,11,2,6/7/2014,390,480,520,1390
80120082,12,3,10/11/2014,460,520,490,1470
80120084,11,1,3/14/2015,380,370,310,1060
80120087,11,1,3/14/2015,400,460,380,1240
80120088,11,1,3/14/2015,530,540,550,1620
80120103,11,1,3/14/2015,440,510,430,1380
80120104,11,1,3/14/2015,430,550,420,1400
80120105,11,1,3/14/2015,450,510,430,1390
80120112,11,1,3/14/2015,530,510,520,1560
80120122,11,1,3/14/2015,570,560,550,1680
80120127,11,1,3/14/2015,440,590,480,1510
80120129,11,1,3/14/2015,590,520,540,1650
80120136,11,1,3/14/2015,500,490,490,1480
80120137,11,1,3/14/2015,480,550,540,1570
80120139,11,1,3/14/2015,560,480,580,1620
80130003,12,1,10/1/2010,330,450,390,1170
80130003,12,2,3/1/2011,420,430,480,1330
80130003,12,3,6/1/2011,360,450,380,1190
80210063,11,1,3/14/2015,520,520,480,1520
80220004,11,1,3/1/2013,540,640,570,1750
80220004,11,2,5/4/2013,560,620,670,1850
80220004,11,3,6/1/2013,560,620,670,1850
80220014,11,1,3/8/2014,370,380,540,1290
80220014,11,2,6/7/2014,390,420,540,1350
80220014,12,3,10/11/2014,460,430,490,1380
80220015,11,1,3/1/2013,580,670,660,1910
80220015,11,2,5/4/2013,550,690,600,1840
80220015,11,3,6/1/2013,550,690,600,1840
80220015,12,4,10/5/2013,560,670,640,1870
80220017,11,1,3/1/2012,520,510,550,1580
80220017,11,2,5/1/2012,550,480,480,1510
80220017,12,3,10/1/2012,460,540,470,1470
80220018,11,1,3/8/2014,250,370,310,930
80220018,12,2,10/11/2014,310,350,300,960
80220021,11,1,3/1/2012,590,750,650,1990
80220021,11,2,5/1/2012,620,760,670,2050
80220021,12,3,10/1/2012,640,740,670,2050
80220026,11,1,5/4/2013,250,340,380,970
80220031,11,1,3/1/2013,400,540,470,1410
80220031,11,2,5/4/2013,450,540,470,1460
80220031,11,3,6/1/2013,490,510,480,1480
80220031,12,4,10/5/2013,550,550,460,1560
80220035,11,1,3/8/2014,550,470,610,1630
80220035,11,2,6/7/2014,560,580,600,1740
80220035,12,3,10/11/2014,600,540,650,1790
80220036,11,1,3/14/2015,480,520,510,1510
80220043,11,1,3/14/2015,230,390,340,960
80220046,11,1,3/8/2014,420,480,430,1330
80220046,11,2,6/7/2014,460,440,470,1370
80220046,12,3,10/11/2014,430,370,400,1200
80220047,11,1,3/8/2014,500,580,580,1660
80220047,12,2,10/11/2014,520,560,630,1710
80220049,11,1,3/8/2014,370,480,380,1230
80220049,11,2,6/7/2014,400,550,490,1440
80220049,12,3,10/11/2014,430,580,470,1480
80220059,11,1,3/14/2015,320,350,320,990
80220060,11,1,3/14/2015,430,490,370,1290
80220061,11,1,3/8/2014,370,400,420,1190
80220061,11,2,6/7/2014,390,410,390,1190
80220061,12,3,10/11/2014,400,390,320,1110
80220067,11,1,3/8/2014,560,570,610,1740
80220067,11,2,6/7/2014,590,610,570,1770
80220069,11,1,3/8/2014,410,570,460,1440
80220069,11,2,6/7/2014,440,570,410,1420
80220069,12,3,10/11/2014,440,590,420,1450
80220070,11,1,3/8/2014,420,500,450,1370
80220070,11,2,6/7/2014,420,540,510,1470
80220070,12,3,10/11/2014,420,540,470,1430
80220074,11,1,3/14/2015,500,620,420,1540
80310007,11,1,5/3/2014,450,530,490,1470
80310093,10,1,6/1/2011,360,460,390,1210
80310093,11,2,3/1/2012,440,550,520,1510
80310093,11,3,6/1/2012,480,610,530,1620
80310102,11,1,5/3/2014,380,500,360,1240
80310102,12,2,10/11/2014,330,470,260,1060
80320003,11,1,5/3/2014,380,600,510,1490
80320003,12,2,10/11/2014,500,580,550,1630
80320011,11,1,5/3/2014,430,560,390,1380
80320011,12,2,10/11/2014,410,550,400,1360
80320012,11,1,5/3/2014,360,430,340,1130
80320012,12,2,10/11/2014,380,440,370,1190
80320020,11,1,5/3/2014,340,470,400,1210
80320022,11,1,5/3/2014,400,390,420,1210
80320022,12,2,10/11/2014,380,360,360,1100
80320023,11,1,5/3/2014,320,430,310,1060
80320023,11,2,1/24/2015,370,440,390,1200
80320027,11,1,5/3/2014,420,490,440,1350
80320028,11,1,5/3/2014,360,530,410,1300
80320028,12,2,10/11/2014,370,410,390,1170
80320030,11,1,1/24/2015,420,460,470,1350
80320031,11,1,5/3/2014,550,420,400,1370
80320031,12,2,10/11/2014,510,360,460,1330
80320038,11,1,5/3/2014,390,560,470,1420
80320041,11,1,5/3/2014,360,460,390,1210
80320042,11,1,5/3/2014,430,510,430,1370
80320045,11,1,5/3/2014,440,470,400,1310
80320054,11,1,5/3/2014,370,440,330,1140
80320054,12,2,10/11/2014,380,440,380,1200
80320055,11,1,1/24/2015,330,450,340,1120
80320058,11,1,5/3/2014,380,410,230,1020
80320059,11,1,5/3/2014,360,420,400,1180
80320059,12,2,10/11/2014,370,410,380,1160
80320063,11,1,5/3/2014,430,450,490,1370
80320063,12,2,10/11/2014,410,440,450,1300
80320072,11,1,5/3/2014,370,470,350,1190
80320072,12,2,10/11/2014,380,470,380,1230
80320074,11,1,5/3/2014,480,400,460,1340
80320074,12,2,10/11/2014,480,390,460,1330
80320075,12,1,10/11/2014,470,470,540,1480
80320078,11,1,5/3/2014,480,530,510,1520
80320080,11,1,1/24/2015,390,340,400,1130
80320086,11,1,1/15/2013,370,340,420,1130
80320086,11,2,5/4/2013,370,400,330,1100
80320086,12,3,10/5/2013,320,420,380,1120
80320087,11,1,1/15/2013,400,430,410,1240
80320087,11,2,5/4/2013,340,390,400,1130
80320087,12,3,10/5/2013,300,400,380,1080
80320090,11,1,5/3/2014,370,430,390,1190
80320090,12,2,10/11/2014,400,380,380,1160
80320093,11,1,1/15/2013,370,310,430,1110
80320093,11,2,6/1/2013,380,370,400,1150
80320093,12,3,10/5/2013,390,330,400,1120
80320098,11,1,1/24/2015,430,480,530,1440
80320101,11,1,1/24/2015,280,440,400,1120
80320105,11,1,1/24/2015,340,410,390,1140
80320110,11,1,1/24/2015,390,380,470,1240
80320115,11,1,1/24/2015,410,450,470,1330
80320116,11,1,1/24/2015,300,480,370,1150
80320118,11,1,1/24/2015,390,460,430,1280
80320124,11,1,1/24/2015,500,650,510,1660
80320126,11,1,1/24/2015,560,520,630,1710
80320128,11,1,1/24/2015,430,500,480,1410
80320129,11,1,1/24/2015,360,260,380,1000
80320130,11,1,1/24/2015,370,440,390,1200
80320133,11,1,1/24/2015,340,460,390,1190
80320137,11,1,1/24/2015,360,600,410,1370
80320144,11,1,1/24/2015,440,510,560,1510
80320145,11,1,1/24/2015,430,580,480,1490
80320148,11,1,1/24/2015,340,470,330,1140
80320149,11,1,1/24/2015,300,370,410,1080
80320151,11,1,1/24/2015,440,560,500,1500
80520003,11,1,1/24/2015,340,420,350,1110
80520006,11,1,5/3/2014,360,440,350,1150
80520006,12,2,10/11/2014,380,410,370,1160
80520009,11,1,1/24/2015,450,450,530,1430
80520010,11,1,5/3/2014,390,500,460,1350
80520010,12,2,10/11/2014,420,500,430,1350
80520012,11,1,5/3/2014,470,500,480,1450
80520012,12,2,10/11/2014,440,470,410,1320
80520019,11,1,1/24/2015,370,420,410,1200
80520023,11,1,5/3/2014,360,470,410,1240
80520023,12,2,10/11/2014,370,430,380,1180
80520027,11,1,5/3/2014,500,540,620,1660
80520030,11,1,5/3/2014,440,620,540,1600
80520034,11,1,5/3/2014,610,570,660,1840
80520034,12,2,10/11/2014,650,520,640,1810
80520037,11,1,5/3/2014,510,600,550,1660
80520037,12,2,10/11/2014,450,510,550,1510
80520039,11,1,1/24/2015,340,420,410,1170
80520043,11,1,5/3/2014,300,410,360,1070
80520043,12,2,10/11/2014,380,390,380,1150
80520045,11,1,5/3/2014,410,530,410,1350
80520049,11,1,1/24/2015,350,440,410,1200
80520051,11,1,5/3/2014,550,540,490,1580
80520051,12,2,10/11/2014,550,510,470,1530
80520052,11,1,5/3/2014,390,410,390,1190
80520052,12,2,12/6/2014,440,490,460,1390
80520053,11,1,5/3/2014,350,510,290,1150
80520060,11,1,5/3/2014,390,470,420,1280
80520064,11,1,5/3/2014,440,510,470,1420
80520066,11,1,5/3/2014,420,530,440,1390
80520066,12,2,10/11/2014,430,530,360,1320
80520067,11,1,1/24/2015,290,450,390,1130
80520072,11,1,5/3/2014,340,380,390,1110
80520081,11,1,5/3/2014,410,360,350,1120
80520081,12,2,10/11/2014,420,350,360,1130
80520082,11,1,1/24/2015,290,470,360,1120
80520084,11,1,5/3/2014,410,470,390,1270
80520084,12,2,10/11/2014,380,410,370,1160
80520088,11,1,5/3/2014,300,380,360,1040
80520088,12,2,10/11/2014,330,410,290,1030
80520094,11,1,1/24/2015,410,380,480,1270
80520100,11,1,5/3/2014,550,530,480,1560
80520100,12,2,10/11/2014,500,510,500,1510
80620004,11,1,5/3/2014,420,610,520,1550
80620004,12,2,10/11/2014,450,560,490,1500
80620007,11,1,5/3/2014,340,490,310,1140
80620007,12,2,10/11/2014,390,480,320,1190
80620011,11,1,5/3/2014,420,320,290,1030
80620011,12,2,10/11/2014,410,400,410,1220
80620012,11,1,5/3/2014,400,490,490,1380
80620012,12,2,10/11/2014,380,490,440,1310
80620014,11,1,5/3/2014,400,400,360,1160
80620014,12,2,10/11/2014,360,410,360,1130
80620017,11,1,5/3/2014,450,410,540,1400
80620017,12,2,11/8/2014,410,450,530,1390
80620018,11,1,5/3/2014,440,440,420,1300
80620018,12,2,10/11/2014,520,440,390,1350
80620020,11,1,1/24/2015,320,400,400,1120
80620022,11,1,1/24/2015,300,420,350,1070
80620027,11,1,1/24/2015,380,310,390,1080
80620028,11,1,5/3/2014,380,470,350,1200
80620028,12,2,10/11/2014,350,530,300,1180
80620032,11,1,5/3/2014,500,450,500,1450
80620039,11,1,5/3/2014,390,470,340,1200
80620047,11,1,5/3/2014,200,370,290,860
80620050,11,1,5/3/2014,450,450,440,1340
80620055,11,1,5/3/2014,420,510,460,1390
80620055,12,2,10/11/2014,430,490,480,1400
80620056,11,1,5/3/2014,360,360,300,1020
80620058,11,1,5/3/2014,480,470,520,1470
80620065,11,1,5/3/2014,400,390,420,1210
80620065,12,2,10/11/2014,390,370,430,1190
80620066,11,1,5/3/2014,450,500,490,1440
80620066,12,2,10/11/2014,470,510,450,1430
80620088,11,1,1/15/2013,360,430,460,1250
80620088,11,2,5/4/2013,370,440,440,1250
80620088,12,3,10/5/2013,360,420,400,1180
80620102,11,1,5/3/2014,390,390,330,1110
80620102,12,2,10/11/2014,400,390,410,1200
80620106,11,1,5/3/2014,440,460,450,1350
80620113,11,1,5/3/2014,550,540,650,1740
80620123,11,1,1/24/2015,390,380,310,1080
80620127,11,1,5/3/2014,360,470,410,1240
80620128,11,1,5/3/2014,200,320,310,830
80620128,11,2,1/24/2015,290,380,330,1000
80620133,11,1,5/3/2014,380,500,480,1360
80620133,12,2,10/11/2014,400,510,500,1410
80720002,11,1,3/8/2014,460,520,510,1490
80720002,11,2,6/7/2014,430,510,550,1490
80720002,12,3,10/11/2014,520,490,540,1550
80720019,11,1,3/8/2014,380,460,440,1280
80720019,11,2,6/7/2014,370,460,510,1340
80720019,12,3,10/11/2014,400,450,490,1340
80720024,11,1,3/8/2014,390,460,450,1300
80720024,12,2,10/11/2014,380,510,390,1280
80720028,11,1,3/14/2015,320,340,310,970
80720029,11,1,3/8/2014,330,400,410,1140
80720029,11,2,6/7/2014,380,410,390,1180
80720029,12,3,10/11/2014,380,420,320,1120
80720034,11,1,3/8/2014,370,420,420,1210
80720034,11,2,6/7/2014,400,410,400,1210
80720034,12,3,10/11/2014,430,430,410,1270
80720037,11,1,3/8/2014,440,470,480,1390
80720037,11,2,6/7/2014,380,510,480,1370
80720037,12,3,10/11/2014,440,510,460,1410
80720039,11,1,3/8/2014,420,470,520,1410
80720039,11,2,6/7/2014,430,550,610,1590
80720039,12,3,10/11/2014,440,480,540,1460
80720044,11,1,3/8/2014,430,510,560,1500
80720044,12,2,10/11/2014,400,400,480,1280
80720060,11,1,3/8/2014,360,420,500,1280
80720060,11,2,6/7/2014,390,440,470,1300
80720060,12,3,10/11/2014,410,460,460,1330
80720061,11,1,3/8/2014,420,500,460,1380
80720061,11,2,6/7/2014,370,470,510,1350
80720061,12,3,10/11/2014,440,460,470,1370
80720062,11,1,3/8/2014,500,520,470,1490
80720062,11,2,6/7/2014,580,580,540,1700
80720062,12,3,10/11/2014,590,490,480,1560
80720066,11,1,3/8/2014,580,450,510,1540
80720066,11,2,6/7/2014,590,530,570,1690
80720066,12,3,10/11/2014,600,520,570,1690
80720072,11,1,3/8/2014,370,330,410,1110
80720072,11,2,6/7/2014,360,410,380,1150
80720074,11,1,3/8/2014,460,540,600,1600
80720074,11,2,6/7/2014,520,590,620,1730
80720078,11,1,3/8/2014,370,530,430,1330
80720078,11,2,6/7/2014,410,560,430,1400
80720078,12,3,10/11/2014,280,520,340,1140
80720080,11,1,3/8/2014,610,570,650,1830
80720080,11,2,6/7/2014,580,620,650,1850
80720080,12,3,10/11/2014,650,610,670,1930
80720081,11,1,3/8/2014,420,430,440,1290
80720081,11,2,6/7/2014,450,530,420,1400
80720081,12,3,10/11/2014,430,510,420,1360
80720086,11,1,3/8/2014,450,440,520,1410
80720086,11,2,6/7/2014,470,440,560,1470
80720086,12,3,10/11/2014,530,430,620,1580
80720088,11,1,3/8/2014,560,580,520,1660
80720088,11,2,6/7/2014,560,560,600,1720
80720088,12,3,10/11/2014,560,540,650,1750
80720089,11,1,3/8/2014,580,450,620,1650
80720089,11,2,6/7/2014,540,470,670,1680
80720089,12,3,10/11/2014,540,470,590,1600
80720091,11,1,3/8/2014,400,470,480,1350
80720091,11,2,6/7/2014,450,520,530,1500
80720091,12,3,10/11/2014,410,480,450,1340
80720092,11,1,3/8/2014,350,380,360,1090
80720092,11,2,6/7/2014,320,320,370,1010
80720092,12,3,10/11/2014,340,320,350,1010
80720094,11,1,3/8/2014,350,500,440,1290
80720094,11,2,6/7/2014,430,520,480,1430
80720094,12,3,10/11/2014,410,500,410,1320
90120006,11,1,3/14/2015,570,580,650,1800
90120008,11,1,3/14/2015,540,530,570,1640
90120013,11,1,3/1/2012,590,610,680,1880
90120013,11,2,5/1/2012,620,630,650,1900
90120013,12,3,10/1/2012,690,630,650,1970
90120014,11,1,3/8/2014,570,630,670,1870
90120014,11,2,6/7/2014,590,560,630,1780
90120014,12,3,10/11/2014,640,590,630,1860
90120019,11,1,3/14/2015,580,470,510,1560
90120027,11,1,3/1/2013,410,550,470,1430
90120027,11,2,5/4/2013,420,520,520,1460
90120027,11,3,6/1/2013,440,560,490,1490
90120027,12,4,10/5/2013,450,540,440,1430
90220005,11,1,3/1/2013,400,450,530,1380
90220005,11,2,5/4/2013,430,470,490,1390
90220005,11,3,6/1/2013,390,510,540,1440
90220005,12,4,10/5/2013,420,460,500,1380
90220006,11,1,3/1/2013,470,640,560,1670
90220006,11,2,5/4/2013,500,630,580,1710
90220006,11,3,6/1/2013,500,630,580,1710
90220006,12,4,10/5/2013,520,630,610,1760
90220007,11,1,3/8/2014,330,370,350,1050
90220007,11,2,6/7/2014,380,380,340,1100
90220011,11,1,3/14/2015,260,230,300,790
90220016,11,1,3/1/2013,450,450,450,1350
90220016,11,2,5/4/2013,460,530,410,1400
90220016,11,3,6/1/2013,440,560,450,1450
90220016,12,4,10/5/2013,530,530,420,1480
90220031,11,1,3/14/2015,660,610,610,1880
90320003,11,1,1/24/2015,520,480,540,1540
90320005,11,1,1/24/2015,450,500,460,1410
90320009,11,1,1/24/2015,360,460,400,1220
90320011,11,1,1/24/2015,410,420,400,1230
90320014,11,1,1/24/2015,390,440,450,1280
90320016,11,1,1/24/2015,320,400,470,1190
90320026,11,1,1/24/2015,450,600,540,1590
90320029,11,1,1/24/2015,470,530,610,1610
90320033,11,1,1/24/2015,480,500,510,1490
90320040,11,1,1/24/2015,550,440,430,1420
90320044,11,1,1/24/2015,390,450,450,1290
90330001,10,1,6/1/2011,480,390,430,1300
90330003,10,1,6/1/2011,350,460,360,1170
90330003,11,2,3/1/2012,480,500,500,1480
90330003,11,3,6/1/2012,390,470,470,1330
90330003,12,4,10/1/2012,370,480,420,1270
90330004,10,1,6/1/2011,490,390,430,1310
90330004,11,2,3/1/2012,480,450,640,1570
90330004,11,3,6/1/2012,500,450,610,1560
90330004,12,4,10/1/2012,570,490,580,1640
90330005,10,1,6/1/2011,480,380,300,1160
90330005,11,2,3/1/2012,440,450,420,1310
90330005,11,3,6/1/2012,400,500,440,1340
90330005,12,4,10/1/2012,420,510,420,1350
90330007,10,1,6/1/2011,390,340,350,1080
90330007,11,2,3/1/2012,400,490,530,1420
90330007,11,3,6/1/2012,430,510,510,1450
90330007,12,4,10/1/2012,440,520,450,1410
90330008,10,1,6/1/2011,280,390,300,970
90330008,11,2,3/1/2012,390,450,410,1250
90330008,11,3,6/1/2012,420,420,420,1260
90330008,12,4,10/1/2012,460,510,370,1340
90330010,11,1,1/15/2013,470,480,410,1360
90330010,11,2,5/4/2013,400,410,390,1200
90330010,12,3,10/5/2013,410,380,390,1180
90330013,10,1,6/1/2011,490,390,390,1270
90330013,11,2,3/1/2012,570,490,450,1510
90330013,11,3,6/1/2012,560,530,480,1570
90330013,12,4,10/1/2012,500,440,420,1360
90330014,11,1,3/1/2012,370,450,390,1210
90330014,11,2,6/1/2012,310,430,370,1110
90330014,12,3,10/1/2012,440,460,380,1280
90330015,10,1,6/1/2011,400,400,340,1140
90330015,11,2,3/1/2012,450,530,480,1460
90330015,11,3,6/1/2012,440,520,490,1450
90330015,12,4,10/1/2012,450,510,430,1390
90520004,11,1,1/24/2015,410,480,410,1300
90520005,11,1,1/24/2015,500,540,540,1580
90520007,11,1,1/24/2015,360,450,380,1190
90520019,11,1,1/24/2015,580,620,570,1770
90520020,11,1,1/24/2015,430,500,530,1460
90520026,11,1,1/24/2015,450,560,560,1570
90520031,11,1,1/24/2015,430,500,560,1490
90520039,11,1,1/24/2015,500,530,440,1470
90520042,11,1,1/24/2015,340,500,400,1240
90520048,11,1,1/24/2015,390,520,510,1420
90520050,11,1,1/24/2015,420,440,450,1310
90520063,11,1,5/3/2014,360,360,430,1150
90520063,12,2,10/11/2014,380,390,430,1200
90520071,11,1,1/24/2015,230,340,340,910
90520079,11,1,1/24/2015,510,480,490,1480
90520087,11,1,1/24/2015,370,420,370,1160
90520088,11,1,1/24/2015,370,460,420,1250
90520089,11,1,5/3/2014,560,590,550,1700
90520089,12,2,10/11/2014,520,590,560,1670
90520096,11,1,1/24/2015,300,360,380,1040
90520098,11,1,1/24/2015,390,470,450,1310
90520104,11,1,1/24/2015,430,410,450,1290
90520109,11,1,1/24/2015,420,500,420,1340
90520184,11,1,1/24/2015,330,540,350,1220
90520196,11,1,1/24/2015,510,610,570,1690
90620004,11,1,1/24/2015,380,350,380,1110
90620014,11,1,1/24/2015,390,450,460,1300
90620020,11,1,1/24/2015,370,350,420,1140
90620022,11,1,1/24/2015,320,380,330,1030
90620030,11,1,1/24/2015,380,390,380,1150
90620031,11,1,1/24/2015,480,500,480,1460
90620054,11,1,1/24/2015,550,610,590,1750
90620060,11,1,1/24/2015,430,450,330,1210
90620062,11,1,1/24/2015,320,490,440,1250
90620063,11,1,1/24/2015,360,410,420,1190
90620065,11,1,1/24/2015,530,500,480,1510
90620070,11,1,1/24/2015,460,490,510,1460
90620071,11,1,1/24/2015,340,490,570,1400
90620075,11,1,1/24/2015,350,410,400,1160
90620077,11,1,1/24/2015,520,510,480,1510
90620087,11,1,1/24/2015,430,480,350,1260
90620091,11,1,1/24/2015,430,640,470,1540
90720002,11,1,3/14/2015,440,530,530,1500
90720014,11,1,3/14/2015,290,390,330,1010
90720017,11,1,3/14/2015,300,280,360,940
90720020,11,1,3/14/2015,420,440,510,1370
90720027,11,1,3/14/2015,330,400,410,1140
90720031,11,1,3/14/2015,540,530,490,1560
90720033,11,1,3/14/2015,370,400,440,1210
90720034,11,1,3/14/2015,400,420,380,1200
90720039,11,1,3/14/2015,470,470,550,1490
90720040,11,1,3/14/2015,350,460,470,1280
90720043,11,1,3/14/2015,470,470,450,1390
90720046,11,1,3/14/2015,550,500,650,1700
90720055,11,1,3/14/2015,440,470,500,1410
90720069,11,1,3/14/2015,470,440,450,1360
90720070,11,1,3/14/2015,380,420,440,1240
90720079,11,1,3/14/2015,590,580,560,1730
90720083,11,1,3/8/2014,410,500,410,1320
90720083,11,2,6/7/2014,460,470,460,1390
90720085,11,1,3/8/2014,460,470,540,1470
90720085,11,2,6/7/2014,430,490,480,1400
90720085,12,3,10/11/2014,500,430,440,1370
90720090,11,1,3/8/2014,530,420,470,1420
90720090,12,2,10/11/2014,560,460,510,1530
93560021,11,1,1/24/2015,330,450,470,1250
100120031,11,1,3/14/2015,490,520,500,1510
100120032,11,1,3/14/2015,530,510,560,1600
100130003,11,1,3/1/2012,460,580,520,1560
100130003,11,2,5/1/2012,470,580,540,1590
100130003,12,3,10/1/2012,490,580,570,1640
100130004,12,1,10/1/2012,290,280,220,790
100130007,11,1,5/4/2013,530,540,510,1580
100130007,11,2,6/1/2013,530,540,510,1580
100130010,11,1,3/1/2013,420,530,460,1410
100130010,11,2,5/4/2013,430,570,590,1590
100130010,11,3,6/1/2013,410,560,470,1440
100130010,12,4,10/5/2013,480,570,420,1470
100130012,11,1,3/1/2013,440,520,510,1470
100130012,11,2,5/4/2013,470,500,540,1510
100130012,11,3,6/1/2013,500,550,540,1590
100130012,12,4,10/5/2013,470,510,560,1540
100330001,11,1,5/3/2014,310,350,430,1090
100520017,11,1,1/24/2015,390,370,310,1070
100720074,11,1,3/14/2015,290,260,330,880
100720077,11,1,3/8/2014,680,710,670,2060
100720077,12,2,11/8/2014,780,720,740,2240
100720085,11,1,3/8/2014,370,400,460,1230
100720085,11,2,6/7/2014,390,490,470,1350
100720085,12,3,11/8/2014,350,500,450,1300
100720089,11,1,3/8/2014,390,310,440,1140
100720089,12,2,10/11/2014,400,410,370,1180
100720109,11,1,3/14/2015,550,520,520,1590
110120099,11,1,3/14/2015,300,450,450,1200
110120100,11,1,3/14/2015,290,320,290,900
110130001,11,1,3/1/2013,340,380,460,1180
110130001,11,2,5/4/2013,370,430,400,1200
110130001,11,3,6/1/2013,340,420,480,1240
110130001,12,4,10/5/2013,410,410,420,1240
110130002,11,1,3/1/2012,300,540,290,1130
110130002,11,2,5/1/2012,330,510,360,1200
110130002,12,3,10/1/2012,380,520,320,1220
110220018,11,1,3/14/2015,390,420,380,1190
110520001,11,1,1/24/2015,520,520,520,1560
110520002,11,1,1/24/2015,400,520,470,1390
110520038,11,1,1/24/2015,380,440,350,1170
110520039,11,1,1/24/2015,360,500,420,1280
110520040,11,1,1/24/2015,430,440,420,1290
110520042,11,1,1/24/2015,410,460,500,1370
110520046,11,1,1/24/2015,390,400,440,1230
110520050,11,1,1/24/2015,430,520,370,1320
110520051,11,1,1/24/2015,410,580,510,1500
110720007,11,1,3/14/2015,440,550,560,1550
110720013,11,1,3/14/2015,580,590,610,1780
110720102,11,1,3/14/2015,400,460,450,1310
110720103,11,1,3/8/2014,400,420,520,1340
110720103,11,2,6/7/2014,450,460,500,1410
110720103,12,3,10/11/2014,460,430,500,1390
110720106,11,1,3/8/2014,420,460,440,1320
110720106,11,2,6/7/2014,430,460,490,1380
110720106,12,3,10/11/2014,430,470,420,1320
120130001,11,1,3/8/2014,580,530,540,1650
120130001,11,2,6/7/2014,610,550,600,1760
120130003,11,1,3/8/2014,400,460,370,1230
120130003,11,2,6/7/2014,410,510,440,1360
120130003,12,3,10/11/2014,420,450,400,1270
120130004,11,1,3/8/2014,350,480,440,1270
120130004,11,2,6/7/2014,390,530,500,1420
120130004,12,3,10/11/2014,430,520,420,1370
120220017,11,1,3/14/2015,300,360,390,1050
120330001,11,1,5/3/2014,420,490,500,1410
120330002,11,1,5/3/2014,380,470,390,1240
120330002,12,2,10/11/2014,400,430,410,1240
120330003,11,1,1/15/2013,440,330,430,1200
120330003,11,2,5/4/2013,410,410,480,1300
120330003,11,3,5/3/2014,470,370,460,1300
120330003,12,4,10/11/2014,440,370,350,1160
120620033,11,1,1/24/2015,450,400,460,1310
130330003,11,1,5/3/2014,420,350,400,1170
130330003,12,2,10/11/2014,370,320,360,1050
130330004,11,1,1/24/2015,360,460,500,1320
130330005,11,1,1/15/2013,420,250,380,1050
130330005,11,2,5/4/2013,310,290,370,970
130330006,11,1,1/15/2013,370,390,430,1190
130330006,11,2,5/4/2013,360,470,420,1250
130330008,11,1,5/3/2014,430,550,600,1580
130330008,12,2,10/11/2014,470,530,590,1590
140130004,11,1,3/14/2015,270,430,410,1110
